+-+-+-+-+-+
|       | |
+ +-+ +-+ +
| |   | | |
+ + + + + +
| |     | |
+-+ + + + +
|   |     |
+ +-+-+ +-+
|     |   |
+-+-+-+-+-+
