+-+-+-+-+-+-+-+-+-+-+-+-+-+-+-+-+-+-+-+-+-+-+-+-+-+-+-+-+-+-+-+-+-+-+-+-+-+-+-+-+-+-+-+-+-+-+-+-+-+-+
|     | |   |         | |   | | |       | | | |         |     |       | |         |       |       | |
+-+ +-+ +-+ + + +-+-+-+ +-+ + + +-+-+ + + + + + +-+ +-+-+-+ + + +-+-+-+ +-+ +-+-+ +-+-+ +-+-+ +-+-+ +
|   |   |   | | | | |   |       | |   | |       | | | |   | |   |           | | | | | | | |   | |   |
+-+ + +-+-+ + +-+ + +-+ + +-+ + + + +-+-+-+ + + + +-+ + +-+-+ +-+-+ +-+-+ +-+ + +-+ + + + +-+ + + +-+
|     | |       |     | |   | |   | |   | | | | |   |   |   |   | | | |   | |   |           |       |
+-+-+ + +-+-+ +-+ +-+-+ +-+-+-+-+ + + +-+ +-+-+ + +-+ +-+-+ + +-+ +-+ +-+ + + +-+-+-+ + + +-+ + +-+-+
|     | |   |   |   |   |   |   | |   |           | | |             | |     |   | | | | | |   | |   |
+-+-+ + +-+ + +-+ +-+-+ +-+ + + + + +-+-+-+ +-+-+ + + +-+-+-+ +-+-+-+ +-+-+ + +-+ + +-+-+ + +-+-+ +-+
| |   |       |     |   | | | | |   | |   | | |           | | |   |   |   | |   |   |   |     | |   |
+ +-+ +-+-+ +-+ +-+-+-+ + + +-+ +-+ + + +-+-+ +-+ + + + +-+ + + +-+-+ +-+ + + +-+-+ +-+ + + +-+ + +-+
|   |     | | | |   | | |     | |     |   |     | | | | | | | | | |         | | |         |     |   |
+-+ + + +-+ + + + +-+ + +-+ +-+ +-+ +-+-+ +-+-+ +-+-+ +-+ + + + + +-+ + +-+ + + +-+ +-+-+ +-+-+-+ +-+
| | | | |   |     | | |   | |     | | | |     | | | |   | |     |   | | |             | |   | | |   |
+ + +-+ +-+ + +-+-+ + +-+ + +-+ +-+ + + +-+-+ + + + + +-+ + +-+-+ +-+-+-+ +-+ +-+ +-+ + +-+-+ + + +-+
| |   | |       |   |   |     | |     |   | |   |       |     |       | | | | | | | | |   | | | |   |
+ +-+ + +-+ +-+-+ +-+-+ +-+ +-+ + +-+-+-+ + + +-+-+ +-+-+-+ +-+ + +-+-+ +-+ +-+ + + +-+ +-+ + + + +-+
| |     |     | | | |     | |   |   |       |     |       | | | | | | |     | |     |   |           |
+ +-+-+ + + +-+ + + +-+-+ + +-+ + +-+-+-+ + +-+-+ + + + +-+ + + +-+ + +-+-+ + + +-+-+-+ +-+ +-+-+ +-+
|   | | | | | |   | | |     | | | |     | |       | | | |       |     | |       |   | | |   |   |   |
+ +-+ + +-+ + +-+ + + +-+ + + + + + +-+-+-+ +-+-+ + +-+-+ + +-+-+ +-+-+ +-+-+-+ +-+ + + +-+ + + +-+-+
| |   | | |   | |   |   | | |       | | | | |       | | | |       | | |     | |   | |   | |   | |   |
+ +-+ + + +-+ + + +-+ +-+-+ + +-+ +-+ + + +-+-+-+ + + + +-+ +-+-+ + + +-+-+ + + +-+ + +-+ + + +-+ + +
| |       | |       | |     |   |     |   | | |   |     | |   | | | |   |   |         |   | |   | | |
+ + + +-+-+ +-+-+-+ + + +-+ + +-+ +-+-+ +-+ + +-+-+ + +-+ + +-+ +-+ +-+ +-+ +-+-+-+ +-+-+ + +-+-+-+ +
| | |   | | |   | |   | | |   | | | |   |     |     | |         | | | |   |     | | |   |     | |   |
+ +-+ +-+ + + +-+ + +-+-+ +-+ + +-+ +-+ +-+-+ +-+-+ +-+ + +-+-+-+ + + + +-+ + +-+ + + +-+-+ +-+ +-+ +
|     | |           |     |   | |   |   |   | |   |   | | |     |           |     |   | |       |   |
+-+ + + + + +-+-+ +-+ +-+-+-+ + + +-+ +-+-+ + +-+ +-+ + +-+ + +-+-+ + +-+-+-+ +-+-+-+ + + +-+ + + +-+
| | |   | | |         | | |       |   |   |             | | |     | |     | |   | | | |     | |     |
+ +-+ +-+-+ +-+ + +-+ + + +-+ +-+-+-+ +-+ + +-+ +-+-+-+ + + +-+-+-+-+-+-+-+ +-+ + + + + +-+ +-+-+ +-+
|     | |   |   |   |   |       |   |   | | |   |     |   |     |                       | |   |     |
+-+-+ + +-+-+-+-+ +-+-+-+-+-+ +-+-+ + +-+ +-+-+-+-+ +-+ +-+ +-+-+-+-+-+-+-+ +-+ +-+ +-+ + + + +-+ +-+
|       |   |         | |   | | |   |     | |   | | |       |   |       | | |   |     |   | |   | | |
+ +-+-+ + +-+-+-+ + +-+ + +-+ + +-+ + +-+ + +-+ + + +-+ + +-+-+ +-+-+ +-+ + + +-+-+ +-+-+-+-+ + +-+ +
|   |       |   | | | | | | | |   | |   | |             | | | |       | | | | |   |     | | | |   | |
+-+-+ + + +-+-+ + +-+ + + + + + + + +-+ +-+-+-+ + +-+ + +-+ + +-+-+-+ + + +-+-+ + + +-+-+ + +-+-+-+ +
|   | | |   | | | |   |     | | | |           | |   | |         | |       |   | |     |   |   | |   |
+-+ +-+ +-+ + + + + +-+ + +-+ + +-+ +-+-+ +-+-+-+-+-+-+ +-+ +-+ + +-+ +-+-+-+ +-+ + + + +-+ +-+ +-+ +
| |   | |   |       |   |       |     |       | | | |     |   |   |     |       | | |   | | | | | | |
+ +-+ +-+-+ + +-+ +-+-+-+ + + + +-+ +-+-+-+-+-+ + + + +-+ +-+-+-+-+-+ +-+-+-+ +-+-+ +-+-+ + + + + + +
|         | | | | |   |   | | | | | |     | |     | |   | | |   |       | |   | | |   | |     | |   |
+-+-+-+ +-+ +-+ + +-+ +-+ +-+ +-+ + +-+ +-+ +-+-+ + + +-+-+ +-+ +-+ +-+ + +-+ + + + +-+ + +-+-+ + +-+
|       | |   |   |   |     | |       |   |       |   |     |       |     | | |     |   | |   | |   |
+-+-+-+ + + + + +-+-+ +-+ +-+-+ +-+-+-+-+ +-+-+-+ + +-+ +-+-+-+-+ +-+-+ + + + +-+-+ +-+ + + +-+ + +-+
|     |     | | | |     |     |   |   |       | |   | |   |   |     |   |   | |         | |         |
+-+ +-+ + + +-+ + +-+ +-+ +-+-+ + + +-+ + +-+-+ +-+ + + +-+ +-+-+-+-+-+-+-+ + +-+ +-+ +-+ + +-+-+ +-+
|     | | |       |       | |   | | | | | |     | | |   |     | | |   |   | |       | |   | | | | | |
+-+ +-+-+-+ + +-+ +-+ +-+-+ +-+ +-+ + +-+ + +-+ + + + +-+ +-+-+ + +-+ +-+ + +-+-+ +-+-+ + + + + +-+ +
|   |   | | |   |           | | |   | |       | |     |   |   | |   | |         |   | | |           |
+-+ +-+ + +-+ +-+-+ + +-+ +-+ + +-+ + +-+-+ +-+-+ +-+-+-+ +-+ + + +-+ +-+-+ +-+-+-+ + +-+ +-+-+-+-+ +
| |       | | |     | | | | |     |     |     | |   |       |     | | |   |     |   |   | |   |   | |
+ +-+ + +-+ +-+-+-+ +-+ +-+ + + + +-+ +-+-+-+ + + +-+ +-+ +-+ +-+ + + + +-+-+ +-+-+ + +-+ +-+ + +-+-+
| | | | | |       |     | | | | | |     | |     |       | | | |         |     | |           |       |
+ + + +-+ +-+ +-+ + +-+-+ + +-+ + +-+ +-+ +-+-+ +-+ +-+-+-+ +-+ +-+ +-+-+-+-+ + +-+-+-+ +-+-+-+ +-+-+
|   |   |   | |           | |   |   | | | |   |         | | | |   | |       |     | | |     | |   | |
+ +-+ +-+ +-+-+-+ +-+-+ +-+ + +-+-+-+ + + +-+ + + + +-+-+ + + +-+-+ +-+ +-+-+-+ +-+ + + +-+-+ + +-+ +
|           | |   |   |   | |     |   | | | | | | |     | | |     |   |   |       | |         |   | |
+-+-+-+ + +-+ + +-+-+ + +-+ + +-+ + +-+ + + + +-+-+ +-+-+ + + +-+-+ +-+ +-+ + +-+-+ +-+-+ +-+-+ +-+ +
| | | | |       |   |     | |   | | |   | | |     | |     | | |     | | | | |   |   |   |   |       |
+ + + +-+ + + +-+-+ + + +-+ + +-+-+ +-+ + + + + +-+ + + +-+ + +-+ +-+ + + +-+-+ + + +-+ + +-+-+ +-+-+
|     |   | | |   |   |   | | | |     |     | |   |   | | |   |           |       | | |       |     |
+-+ +-+-+-+-+-+ +-+-+ +-+-+ + + + + +-+ +-+ + +-+-+ +-+-+ +-+ +-+-+-+-+ +-+-+-+ +-+ + +-+ +-+-+ + + +
| | |     |   |     | |   |       | |   | |     |       | | |   |     |   |   | | |   | | |     | | |
+ + + +-+-+-+ +-+-+ + + +-+ +-+ +-+-+-+-+ + +-+-+-+ +-+ + + + +-+-+ +-+ +-+-+ + + +-+-+ + + +-+-+ + +
|     |   |   |       |   | |   | |     | |     |   |     |       |     | | | |     |   |       | | |
+-+ +-+-+ +-+ +-+ + + + +-+-+-+ + + +-+-+ + +-+-+ +-+-+-+-+ +-+-+-+-+-+ + + + + +-+-+ + + +-+-+-+-+ +
|     | |   |     | |     |         | | | | | |       |       | | | | | |   |   | | | |           | |
+-+ +-+ + +-+ + +-+-+ +-+-+-+-+ + +-+ + + + + +-+ + +-+-+ +-+-+ + + + + + +-+ +-+ + +-+ +-+ + +-+ +-+
|     | |   | | |       |     | |   |   | |   |   |   |   | | |   |   |                   | | | |   |
+-+-+ + + +-+-+-+-+ + +-+ +-+-+-+ +-+-+ + + +-+-+ +-+-+-+ + + +-+ +-+ + +-+-+ + +-+ +-+-+-+-+-+ +-+-+
|   |       | | |   | | | | |   |   |   |       |     | | |   | |       |   | | |           | | |   |
+ +-+ +-+ +-+ + +-+-+ + + + + +-+ + +-+ + +-+ +-+ +-+-+ + +-+ + +-+-+-+-+-+ +-+ +-+ + +-+-+-+ + + +-+
|   | | |     |         |         | | | | |   |           |   |     |   |   |     | |   |       |   |
+ + +-+ + + +-+-+-+-+ + +-+-+-+ + +-+ + +-+-+ + + +-+-+ +-+ +-+-+-+ + +-+ + + + +-+ + +-+ +-+ +-+ +-+
| |   | | |   |   | | |   |     |   | | |   |   | | | | | | |   | | | | | | | |   | |       | |   | |
+-+ +-+ +-+ +-+-+ + + +-+-+-+-+-+-+ + + +-+ + +-+-+ + +-+ + + +-+ + + + +-+ +-+ + +-+ + + + +-+ +-+ +
| | |   |     |       |     | | | |     | |   | | | |   |       |     | |     | | | | | | | |     | |
+ + +-+ +-+-+ + +-+-+-+ +-+-+ + + + + +-+ +-+ + + + + + +-+ +-+-+-+-+ + +-+ +-+-+ + +-+-+-+-+ +-+-+ +
| |   |   | |     | |     | | | | | |       | |   |   |   |   | | |   |   | | | |     |   |     |   |
+ + +-+ +-+ +-+-+ + +-+ +-+ + + + +-+ + + +-+ +-+ + +-+-+-+ +-+ + +-+ + +-+ + + + + + + +-+-+ +-+-+ +
|       |     | |   | | | |     | | | | | | | |       | |   | | | |     |     |   | | | |   |       |
+-+-+ +-+-+ + + + +-+ + + +-+-+ + + +-+-+ + + +-+ +-+-+ + +-+ + + +-+-+ +-+-+ + +-+ +-+ + +-+ +-+ +-+
|     | | | | |   |       |   |     |       | |     |   |       |   | | | |       |   |   |   |     |
+-+-+ + + +-+ +-+ +-+-+-+ +-+ + +-+ +-+-+ +-+ + +-+-+ + + +-+-+-+ +-+ + + +-+ +-+ +-+-+ +-+-+ +-+ +-+
|       | | |   |   |     | |     | |     | | | | |   |   | | | | | | |     | |     |   | |   | | | |
+ +-+-+ + + + +-+ +-+-+ +-+ + +-+ +-+ +-+ + + + + +-+-+-+ + + + + + + + + +-+ +-+-+-+ +-+ + +-+ +-+ +
| | | | |   |     |         |   | | | |             |       |           | | |     |   |             |
+-+ + + + +-+-+-+ +-+-+ +-+ + +-+-+ +-+-+-+ +-+-+-+-+-+-+ +-+-+-+-+-+ +-+-+ + +-+-+ +-+-+ + + +-+-+-+
|   | |   | |         | |   |   |   |   |   | | |       |     |   |       |   |           | |       |
+-+ + +-+ + +-+-+-+ + +-+-+ + +-+-+ + +-+ + + + +-+ +-+-+ +-+-+-+ +-+ +-+ +-+ +-+-+ +-+-+-+-+-+-+ +-+
| | |   |   | |   | | |   |     | |     | |   | | |   |     |   | |     | |   |   |         |   |   |
+ + + +-+ + + +-+ + +-+ +-+ +-+ + +-+ +-+-+ +-+ + + +-+-+ +-+-+ + + +-+-+-+-+ + +-+ +-+ + +-+ +-+-+-+
| |   | | |   | |         | | | | |       | | |     | | |   | |       |   |       |   | | |     | | |
+ + + + +-+ +-+ +-+ +-+-+ + + +-+ +-+ +-+ + + + + +-+ + + +-+ + + +-+-+ +-+-+-+ +-+ +-+-+-+ +-+ + + +
| | |     | |     | |   |     | | | | | | | |   |         |     |   |     | | |         |     | |   |
+ + + +-+-+ +-+ +-+-+-+ + +-+-+ + + +-+ + + + +-+-+-+ +-+-+-+-+ + +-+-+ + + + + +-+-+-+ + +-+-+-+-+ +
| | |   |   |   |         | |     | | |           | | | |   | | | |   | | | |       | |     | | | | |
+ +-+-+ +-+ + +-+ + + +-+ + +-+ + + + +-+-+ +-+-+-+ +-+ + +-+ + +-+-+ +-+ + + + +-+-+ +-+ + + + + + +
|   | |   | | | | | | |   |   | |   |     |     |     | | | | |   |   |       |     | | | | | |     |
+ + + +-+ + + + +-+-+-+-+ + +-+-+-+ +-+ +-+-+ + +-+ +-+ + + + + +-+ +-+-+ + +-+-+-+-+ + +-+-+ +-+ + +
| |   |     |   | |   |           | |     | | | | |     | | | |     | |   | |   |       |     |   | |
+-+-+ +-+ + + +-+ +-+ +-+ + +-+-+-+ +-+ +-+ + +-+ + +-+-+ + + +-+ +-+ + +-+-+ +-+-+ +-+ + +-+-+ +-+-+
|       | |     |   | |   | | |       |     |           | |   | |   | |   |   | | |   | |   |   | | |
+-+-+-+ +-+ + +-+-+ + +-+ +-+ +-+-+ +-+-+-+ + +-+-+-+-+-+ +-+ + + +-+ + +-+-+ + + + +-+-+ + +-+ + + +
|   |   | | |     | |   | |   |   |       | | |   | | |     |       |     | |           | | | | | | |
+-+ +-+ + +-+ +-+-+ + + + + + +-+ + +-+ +-+ + + +-+ + + +-+ +-+-+ +-+ +-+-+ + + +-+ +-+-+-+ + + + + +
|       | |           | | | |   |   |     |         | | |     |               | | | |   | | | |     |
+-+-+-+ + +-+-+ +-+ + +-+ +-+ +-+-+-+-+ + + + +-+ +-+ + +-+-+-+-+ + +-+ + +-+ +-+ +-+-+ + + + +-+ +-+
| |       |   |   | |     |     | | | | | | | |     |   | |   |   |   | | |   | |   | | |     |     |
+ +-+ +-+ +-+ +-+-+-+-+ +-+ +-+-+ + + + +-+ +-+ + +-+ +-+ + +-+-+-+ +-+-+-+-+ + + +-+ + +-+ +-+-+ +-+
|   | | | |   |   | | |   | | |     |     |   | | |   |   | | | |     | | |               | |       |
+-+ + + +-+-+ +-+ + + +-+ + + +-+ +-+-+ + +-+ +-+ + +-+-+ + + + +-+ + + + +-+ +-+-+ +-+-+-+ +-+ +-+ +
| |       |   | | |   |     | | | |     | | | |   |   | |     |     | |     |     | |   |         | |
+ +-+ +-+-+-+ + + + + +-+ +-+ + + +-+-+ +-+ +-+ + + + + + +-+-+-+-+ +-+ +-+ +-+-+ +-+ +-+-+ +-+-+ +-+
|           | | |   | |       | |   |   |     | |   |     |   | |   |     | |   | |     |     | |   |
+ +-+-+ +-+-+ + + +-+-+ + +-+-+ + +-+ +-+ +-+-+-+ +-+-+-+-+-+ + + +-+-+ +-+-+-+ +-+-+ + +-+ +-+ +-+-+
| | | | |       |   | | | |   |   |           | |     | | |   |     | | | | |       | |     | |   | |
+-+ + + +-+-+-+ + +-+ +-+ + +-+-+ +-+-+-+ + +-+ + +-+-+ + + +-+-+ +-+ + + + + +-+-+-+-+ +-+-+ + + + +
| |               | |   |     | | |     | | | | |     |   |     |   |             |   |   | |   | | |
+ + + + + +-+ +-+ + + +-+ + +-+ + +-+ +-+-+ + + + +-+-+ + + +-+-+ +-+ +-+-+-+ +-+-+ +-+ + + + + +-+ +
| | | | | | | | |       | | | | |     |   |       |   | | | |         | | |       | | | | |   | |   |
+ +-+-+-+-+ +-+ + +-+-+-+-+ + + +-+-+ +-+ + +-+ +-+ +-+ +-+ + + + +-+-+ + +-+ + +-+ + + +-+ +-+-+ + +
| | |   | |       |   |           |   | |     |   | |   | |   | |           | |   |           |   | |
+ + + +-+ +-+-+-+ + +-+ +-+-+-+ +-+-+ + +-+ +-+-+-+ + +-+ + +-+-+ +-+-+-+-+ + +-+-+ + + + + +-+-+ +-+
| | | |   |     |   | | | | |     | | | |           | | |     |         |   | | |   | | | | |   |   |
+ + + +-+ +-+-+ + +-+ +-+ + +-+ +-+ + + + + +-+-+-+-+ + + +-+-+-+ +-+ +-+-+-+-+ +-+ +-+ + +-+ +-+-+ +
|       | | | |   | | | | | |     |       |                   | | | |   |       |   | | | |       | |
+ + +-+-+ + + +-+ + + + + + +-+ +-+ + + + + +-+-+-+-+ +-+-+-+-+ + + +-+-+ +-+-+-+-+ + + + +-+-+ +-+ +
| | |     | | |     | |         | | | | | |       |       | | |             | |       | | |   | |   |
+-+ + +-+ + + +-+ +-+ +-+ + +-+-+ +-+-+-+-+ + +-+-+-+ +-+ + + +-+ +-+-+-+-+-+ +-+ +-+ +-+-+ +-+ +-+ +
|   | |     | |     |   | | |   |   | | |   | | |     |     | |     |         |   | |     |         |
+-+ +-+-+ +-+ +-+ +-+ +-+-+ + +-+ +-+ + +-+ +-+ +-+-+ +-+ +-+ +-+ + +-+-+ +-+-+-+ + + +-+ +-+-+ +-+-+
|     |   | |     |   |   |       | |           | | | | | |     | | | |         |   | | | |         |
+-+ +-+-+ + +-+ + + +-+-+ + +-+-+ + +-+-+-+ +-+-+ + +-+ +-+ +-+-+-+-+ +-+-+-+-+ + +-+ + +-+-+ +-+ +-+
| | | | |   |   |   |     | |   | |   | |           |       | |   |   | |   |   | |   | |   |   | | |
+ + + + + +-+-+-+-+ +-+ + + +-+ +-+ +-+ +-+ +-+-+-+-+-+ +-+ + + + +-+ + +-+ + +-+ +-+-+ + +-+ +-+-+ +
| | |     | | |   |   | |     |   | |   |           |   | |     | | |   | |   | |                 | |
+ + +-+ + + + + +-+ + +-+ +-+-+ +-+ +-+ + +-+ +-+ + + + + + + + +-+ + +-+ +-+ + + +-+ +-+-+ +-+-+-+ +
|       | | |   | | |         |   | |     | | | | | | | |   | | | |     |   |   | |   | | |       | |
+-+ + + +-+ + + + +-+-+ +-+ +-+ +-+ + +-+ + +-+ + +-+ +-+ + + +-+ + +-+-+ +-+ + + +-+ + + +-+-+-+-+ +
|   | | | |   | | |     |   |     |     |       | |   | | | | |       | |     |     | | |   | |     |
+ +-+-+ + +-+ +-+ +-+-+ +-+-+-+ +-+ +-+-+-+-+ + + + +-+ +-+ +-+-+-+ +-+ +-+-+ +-+-+-+-+ + +-+ + + +-+
| | |         |   |     | | |   |     |     | | | |     |   | |       | |       |               | | |
+-+ +-+-+-+-+ + +-+-+ +-+ + +-+ + + + + +-+-+-+-+-+ +-+-+-+-+ +-+-+ +-+ +-+ +-+-+ +-+-+-+-+ +-+ + + +
|     |             | | |       | | | | | |     | |       | |       | |   | | |           | | | | | |
+-+ +-+-+-+-+ + + +-+ + +-+-+-+ +-+ +-+ + +-+ +-+ +-+ +-+-+ + +-+ + + + +-+ + + + +-+ +-+-+-+ +-+-+ +
| |   | | |   | |       |     |       |     |   |   | |   | | | | |           | |   |   |           |
+ + + + + +-+ +-+ +-+-+ + +-+-+-+ + +-+ +-+-+ +-+ +-+ + +-+ +-+ +-+ +-+ +-+ + +-+ +-+-+-+ +-+-+-+-+ +
|   |           | |           |   | |       | |   |         |   | | | |   | | |   | | |       | | | |
+-+-+ + + + + +-+ +-+-+ +-+ + +-+ +-+ +-+-+-+ + +-+ + +-+-+-+-+ + + + +-+-+-+-+-+ + + + +-+-+-+ + +-+
|     | | | | |     |   | | |       | |           | | |       | | |   |     | |     | |   |         |
+-+ +-+ +-+-+-+ +-+-+-+-+ +-+-+ + + + +-+ +-+-+ +-+-+ + +-+-+-+ + + +-+-+-+ + +-+ +-+ + + + +-+-+-+ +
| | | |   |   |       | | |     | |           |             |     | |   |             | |   |   | | |
+ +-+ + +-+-+ + +-+-+-+ + +-+-+-+-+ + +-+ +-+-+-+ + + + + +-+-+-+ + + +-+ + + +-+ +-+-+-+ +-+-+ + + +
|       |         | |   |   |       |   | |     | | | | | |   | | | | |   | |   | | |   |     | | | |
+ + + + +-+ +-+-+-+ +-+ +-+ +-+ + + + +-+-+ +-+ + +-+-+-+-+ +-+ + + + + + + +-+-+-+ + +-+-+ + + + +-+
| | | | | | | | |   |   |   | | | | | |   |   | | | | | |   | |   | |   | |   |   |       | | |     |
+-+-+-+-+ +-+ + +-+ +-+ +-+ + + +-+-+ + +-+ +-+-+-+ + + +-+ + +-+ + + +-+-+-+-+ +-+ +-+ +-+ + + +-+ +
| | |       | | | |   |             | | |     |     |   | |     | |           |   |   |   | | | | | |
+ + +-+-+ + + + + + + +-+-+-+ +-+ +-+-+ + + + + +-+-+-+ + + +-+-+ + +-+-+-+-+-+ + + +-+-+-+ +-+ + +-+
|     | | |       | | | | |   |   | | | | | |   | |       | | |           |   | | | |   | |         |
+-+-+ + +-+-+ + +-+ +-+ + +-+-+-+ + + + + +-+-+-+ +-+ +-+-+ + +-+ + +-+ +-+-+ + +-+ +-+ + + +-+ +-+-+
| | |   |   | |     | | |   |   | |               | | |   |   |   | | | |     |   |   |       |   | |
+ + + +-+-+ +-+-+-+ + + + +-+-+ + +-+ +-+ +-+-+-+-+ + + +-+ +-+ + +-+ +-+-+ +-+-+ + +-+-+-+ + +-+-+ +
| | |     | | |     |   | |             |       |   | |         |         |   | |           | | |   |
+ + +-+ +-+ + +-+ +-+-+ + +-+-+ +-+ +-+-+-+-+-+-+ +-+ +-+ + +-+ + +-+-+-+ + +-+ + +-+-+-+ + +-+ + + +
|           |   | | | |   | | |   |   |   |     |   | |   | |   |     |             |     |       | |
+-+ + +-+ +-+-+ + + + +-+ + + + +-+-+-+ +-+-+ +-+ +-+ +-+ +-+-+ + +-+-+-+ + + +-+ + +-+ + + +-+ + +-+
|   | |   |   | |         |             |       |     | |   | | |     |   | |   | | | | | | |   |   |
+-+ + + + + +-+ + + +-+-+ +-+-+ +-+-+ + +-+-+-+ + +-+-+ + +-+ +-+-+-+ +-+ + + + +-+ + + +-+-+-+ +-+-+
|   | | |         | |   | |   | |   | | | |       | |       | |     |   | | | | | | |     | |   |   |
+ + + + +-+-+ + + +-+-+ + + +-+ + +-+-+-+ + + +-+-+ + + + +-+ + +-+-+ +-+-+-+ +-+ +-+ +-+ + +-+ + +-+
| | | | |     | | |   |       |   |   |     | | | |   | |   |     | |   | | |   |     |     |     | |
+-+ +-+-+-+-+ +-+-+ + + + +-+ + +-+ +-+-+-+ +-+ + + + + +-+ + +-+-+ +-+-+ + + +-+-+-+-+ + +-+-+ +-+ +
|   |       | | |   |   | |     |         |         | | | |     |           | |     | | |   | |     |
+-+ +-+-+ +-+-+ +-+ +-+-+ +-+-+ +-+ +-+ +-+ +-+-+ +-+ + + +-+ +-+ +-+ +-+-+-+ +-+ +-+ + +-+ + + +-+-+
|   | |           |   | | | |       |   | | |   |   | |   |         | | |           |   |     |     |
+-+-+ +-+-+ + +-+ +-+-+ + + +-+ +-+-+-+-+ + +-+ +-+-+-+-+-+ +-+ + +-+-+ + + + + + + +-+ +-+ +-+-+ + +
| | |   | | | |   |     | |       |   |                   | |   |     | | | | | | | | | |     |   | |
+ + +-+ + + + + +-+-+-+ +-+-+-+ +-+ +-+ + +-+ +-+-+-+-+ + +-+-+ +-+ +-+ +-+-+ +-+-+-+ +-+-+ + +-+-+ +
| | | | | | | | |             |         |   |     |     |     |   |   |   | |     |   |   | | | |   |
+ + + + + +-+-+ +-+ + +-+-+-+ + +-+ + + + +-+-+ +-+-+ + + +-+-+-+ + +-+-+ + +-+-+ + +-+-+ +-+-+ + + +
|                   | |         |   | | | |   | |   | | | | |     | |           |           |   | | |
+ + + + + + + + + + + + +-+-+ + +-+ +-+-+-+ +-+-+-+ +-+ +-+ + + + +-+ +-+-+-+ +-+ + +-+-+ +-+ +-+ + +
| | | | | | | | | | | |   |   | |                   |       | | |         |     | | |   |       | | |
+-+ +-+ +-+-+-+ + +-+-+ + +-+ + +-+ + +-+ + +-+ + +-+-+ +-+-+-+-+-+ + +-+ + + +-+-+-+ +-+-+ +-+ + + +
|   |   |       | |   | | |   | |   |   | |   | |   |           |   |   | | |             |   | | | |
+ +-+-+-+-+-+ + +-+-+ +-+ + +-+-+-+ +-+-+ + + +-+ +-+-+ +-+-+-+-+-+-+ +-+-+ +-+ +-+-+-+ + + +-+-+-+ +
|     |     | | |         | |           | | |   |     |   |     |         | | |     |   | |       | |
+-+-+-+-+ +-+ +-+ + + +-+-+-+ + +-+ +-+ +-+ +-+-+ +-+ +-+ + +-+-+-+ +-+-+-+ + + +-+-+ +-+-+ + + + +-+
|   | |   |     | | | |       | |     |   |   | | |   | | | |   |   | | | | | |     | | |   | | |   |
+-+ + +-+ +-+-+-+-+ +-+-+ + + +-+ + +-+-+ + +-+ +-+-+-+ +-+ + +-+-+-+ + + +-+ + + + + + +-+-+-+-+-+-+
|                   | | | | |   | |   |   |                   | |   |         | | | |     | |       |
+ + +-+ + + + + +-+ + + + +-+ + + +-+-+-+-+ +-+-+ +-+ +-+ + +-+ +-+ + +-+ + +-+-+-+ + +-+-+ +-+-+ + +
| | |   | | | | |   |       | | |     | |       | |   |   |             | |     |   |             | |
+ +-+-+-+ +-+ + + +-+ +-+-+-+-+-+ +-+-+ +-+ +-+-+-+-+-+-+-+ +-+ + +-+-+-+-+-+ + +-+ + +-+-+-+ + +-+-+
|   | |   |   | |   |   |   |           |                 |   | |   |       | | | | | | |     |     |
+ +-+ + +-+ + +-+ +-+ +-+-+ +-+-+ + + + + + + +-+-+-+ +-+-+-+ +-+-+ +-+ + + +-+-+ +-+ + +-+ +-+ +-+-+
| |     |   |   | |     |         | | | | | |       |       |     |     | |         |     |   |     |
+-+-+-+-+-+-+-+-+-+-+-+-+-+-+-+-+-+-+-+-+-+-+-+-+-+-+-+-+-+-+-+-+-+-+-+-+-+-+-+-+-+-+-+-+-+-+-+-+-+-+